; Spawns vs Outs
XIIXXXXXX
X       X
X       X
I       O
X       X
X       X
X       X
XXXXXXOOX
