; This is a basic test map to make sure things work
XiXXXXXXX
X       X
X       X
X       X
X       X
X       X
X       X
XXXXXXXiX
