XXXXXXXXXXIIIIIIIIXXXXXXXXXX
X                          X
X                          X
X                          X
X                          X
X                          X
X                          X
X                          X
I                          O
I                          O
I                          O
I                          O
I                          O
I                          O
X                          X
X                          X
X                          X
X                          X
X                          X
X                          X
X                          X
X                          X
XXXXXXXXXXXOOOOOOOXXXXXXXXXX
