XXXXXXXXXXXXXXXXXXXXXXXXXXXX
X                          X
X                          X
X                          X
X                          X
X         X X  X X         X
X         XXXXXXXX         X
X         X XXXX X         X
X         XXXIIXXX         X
X         XXX  XXX         X
X                          X
X                          X
X                          X
X                          X
X                          X
X                          X
X                          X
X                          X
X                          X
X                          X
X                          X
X                          X
X                          X
XXXXXXXXXXOOOOOOOOXXXXXXXXXX