; The challenge map for the first week
XXXiXXXXXXXXXXXXXXXXXXXXXXXX
X      X                   X
X      X                   X
X      X                   X
X      X                   X
X      X                   X
X      X                   X
X      X            X      X
X      X            X      X
X      X            X      X
X      X            X      X
XXX  XXXXXXXX  XXXXXXXX  XXX
XXX  XXXXXXXX  XXXXXXXX  XXX
X      X            X      X
X      X            X      X
X      X            X      X
X      X            X      X
X                   X      X
X                   X      X
X                   X      X
X                   X      X
X                   X      X
X                   X      X
XXXXXXXXXXXXXXXXXXXXXXXXXiXX